101010101010101010101010101010101010101010101010101010101010
101800000000000000000000000000000000000000000000000000001910
100000000000000000000000000000000000000000000000000000000010
100000000000000000000000000000001200000000000000000000000010
100000121212000000000000000000001200000000000000000000000010
100000000000000000000000000000000000000000000000000000000010
100000000000000000000000000000001212000000000000000000000010
100000000000000000000000000000001200000000000000000000000010
100000000000000000000000000000000000000000000000000000000010
100000000000000012120000000000000000000000000000000000000010
100000000000000000000000000000000000000000000000121200000010
100000000000000000000000000000000000000000000000000000000010
100000000000000000000000000000000000000000000000000000000010
100000000000000000000000000000000000121212000000000000000010
100000000000000000000000000000001212121200000000000000000010
101300000000000000000000000000000000000000000000000000001410
101010101010101010101010101010101010101010101010101010101010
