101010101010101010101010101010101010101010101010101010101010
100000000000000000000000000010100000000000000000000000000010
100010111111100010100010100000000010100010100010111111100010
100011000000100010000000100011110010000000100010000000110010
100011000000100010001100100000000010001100100010000000110010
100010101010100010000000101010101010000000100010101010100010
100010000000100010101010100000000010101010100010000000100010
100010001100100000000000000011110000000000000010001100100010
100000000000110011111111111110101111111111110011000000000010
100010001100100000000000000011110000000000000010001100100010
100010000000100010101010100000000010101010100010000000100010
100010101010100010000000101010101010000000100010101010100010
100011000000100010001100100000000010001100100010000000110010
100011000000100010000000100011110010000000100010000000110010
100010111111100010100010100000000010100010100010111111100010
100000000000000000000000000010100000000000000000000000000010
101010101010101010101010101010101010101010101010101010101010
