101010101010101010101010101010101010101010101010101010101010
100000000000000000001000000010000000000000000000000000000010
100000100010101010001000100010001010000000000010000000100010
100000100010000010000000100000001000000000000010100000000010
101200100010000000101010101000101000000000000010101010000010
100010100000001000100000001000000000000000000000101010100010
100012001010101000000010001010100010000000000000101010100010
101210120000000000001000001000000010000000000000001010100010
101200001012101210000000100000000000000000000100000010100010
100010000000120012101010001200100000100000000000000000000010
100010120012001000121200000000000010001000000000000000000010
100000000010001000000000120012000000000000001080000000000010
100010121200121000001012001212000010000000000000010000000010
101210001200100000120012001200001000000010100000100000000010
100010001000100010120012120010000000101000000000001000000010
100000000000000012000000000010000000000000000000000000000010
101010101010101010101010101010101010101010101010101010101010
