101010101010101010101010101010101010101010101010101010101010
100000000000121012121200001200100000000000001000000000000010
100010000010000000000000100012000010000000001000100000100010
100000100000001010101012101010101200001210001000001210100010
101200100000100000000000000000101000001210001000000000000010
101200001010000012101010101000000000101212000000001010100010
100010000000101000000000000000101212001012000000000010000010
100000001000001000101010121010000010001212000000000000000010
100010001010000000000000000000100000000010001012101210001010
100000001000001010121010101000100010000000001012101210001010
101010001200120000000000000000100000001000000000101210001010
101200001000000010000000101200000000101010001000000000000010
100000120010121000001000001200101000001000001000100010000010
100010001000120000000010001000000010001000000000000000001010
100000100000000000100010001010001210121210101000100000000010
100000000000001000000010120000000000000000000012121000000010
101010101010101010101010101010101010101010101010101010101010
