101010101010101010101010101010101010101010101010101010101010
380000380038103838380121023838120010000000000000100000000000
383810101110110138001038010010380001200001000000000100010000
100038110101001011013801103801383810803880383880800012101000
383838111000381100001001011101080808100000003800080800000000
103838101038111010023820811001380002000000003800808080100010
103810100110113811110111101010100101010101380810080000080000
380038101038381138381038103800103810383838083838380000000000
103811113800380001381101110110013801010000000038382100008120
103838111111103810380138381038001101080800080808080808080808
381111101010103838010111381010110010010180003800000000800000
383838381138383838111138110011111100800000380000008080008080
380011100138111038110138011000111138808000808080808080808100
113811380038103811380180383838383838803880800080000000008000
383838383838110010103811011101010038000000000000000000080800
100001013810011011111111381138100011000800080800080808080000
381110383811010101110001101111011100000000000000000010101010
