101010101010101010101010101010101010101010101010101010101010
100000000010121012121200001200100000000000001000000000000010
100010101111011000000000100012000010000000001000100000100010
100011101101011010101012102101080808080808080001210100010000
101100111000101000000000080808100000000000080800000000001000
101101111011110020020808000000200000000000080808010001000000
101010101011111011080000000001010808100800000800000808000808
100011111111111118101100000808000000000000000008000000000008
101011111101100111110001180000000000021000081208080808101000
100111110111011011101101100808000808080808080808080808000008
101111111100011110011101011800000000000008000000080808080000
111111111011011010100108180800000010000008080008080800000000
100011111010110100101100080008080800080808080808080810000010
110110001011110010180008000800080008080008000000000800001010
111000101000100000000000080008000000000000000000080800000010
100000001100001000000000000000000800080800080808080000000010
101010101010000000000000000000000000000000000000000010101010
